######
######
####B#
#### #
#### #
#A   #